11111111111111111111011111111111
1000000C000000000000000000000001
1C0000CC0000CC0000CC0000CC0000C1
1E00000000000C00000C00000C000001
1P000000C00000000000000000000001
10000000C00000000000000000000001
10000000C00000000000000000000001
11111111111111111111111111111111